/ / 0 / /
/ 0 0 0 /
B 0 0 E B
/ 0 0 0 /
/ 0 B 0 0