/ / B 0 0
/ / 0 0 0
B E 0 0 /
0 / 0 0 /
/ / 0 0 /